player(2, 18, 90)
7
1 1 1 1 1 1 1 1 1 1 1 1 1 1 1 1 1 1 1 1 1 1 1 1 1 1 1 1 1 1 1 1 1 1 1 1 1 1 1 1
1 0 0 0 0 0 0 0 0 0 0 0 0 0 0 0 0 0 0 0 0 0 0 0 0 0 0 0 0 0 0 0 0 0 0 0 0 0 0 1
1 0 0 0 0 0 0 0 0 0 0 0 0 0 0 0 0 0 0 0 0 0 0 0 0 0 0 0 0 0 0 0 0 0 0 0 0 0 0 1
1 0 0 0 0 3 3 3 3 3 3 3 3 3 3 3 3 3 3 3 3 3 3 3 3 3 3 3 0 0 0 0 0 0 0 0 0 0 0 1
1 0 0 0 0 3 0 0 0 0 0 0 0 0 0 0 0 0 0 0 0 0 0 0 0 0 0 3 0 0 0 0 0 0 0 0 0 0 0 1
1 0 0 0 0 3 0 0 0 12 0 0 0 0 0 12 0 0 12 14 0 12 14 0 12 14 0 3 0 0 0 0 0 0 0 0 0 0 0 1
1 0 0 0 0 3 0 16 0 0 0 0 0 0 0 0 0 0 0 0 0 0 0 0 0 0 13 3 0 0 0 0 0 0 0 0 0 0 0 1
1 0 0 0 0 3 0 16 0 0 0 0 0 0 0 0 0 0 0 0 0 0 0 0 0 0 13 3 0 0 0 0 0 0 0 0 0 0 0 1
1 0 0 0 0 3 0 0 0 12 0 0 0 0 0 12 0 0 12 14 0 12 14 0 12 14 0 3 1 1 1 0 0 0 0 0 0 0 0 1
1 0 0 0 0 3 0 0 0 0 0 0 0 0 0 0 0 0 0 0 0 0 0 0 0 0 0 7 0 0 1 0 0 0 0 0 0 0 0 1
1 0 0 0 0 3 3 3 3 3 3 2 7 2 3 3 3 3 3 3 3 3 3 3 3 3 3 1 1 0 1 0 0 0 0 0 0 0 0 1
1 0 0 0 0 0 0 0 0 0 0 2 0 2 0 0 0 0 0 0 0 0 0 0 0 0 0 0 1 0 1 0 0 0 0 0 0 0 0 1
1 0 0 0 0 0 0 0 0 0 0 2 0 2 0 0 0 0 0 0 0 0 0 0 0 0 0 0 1 0 1 1 1 1 1 0 0 0 0 1
1 0 0 0 0 0 0 0 0 0 0 2 0 2 0 0 0 0 3 3 3 3 3 3 3 0 0 0 1 0 1 13 13 16 1 0 0 0 0 1
1 1 1 1 1 1 1 1 1 0 0 2 0 2 0 0 0 0 3 0 0 0 0 3 3 0 0 0 1 0 0 0 0 16 1 1 1 1 1 1
1 0 0 0 0 0 0 0 1 0 0 2 0 2 0 0 0 0 3 0 0 0 14 10 3 0 0 0 1 0 1 13 13 16 1 0 0 0 0 1
1 0 0 12 0 12 0 0 1 0 0 2 0 2 0 0 0 0 3 0 0 0 0 3 3 0 0 0 1 0 1 1 1 1 1 0 0 0 0 1
1 0 0 0 0 0 16 0 1 2 2 2 0 2 2 5 2 2 3 0 0 16 0 0 3 1 1 1 1 0 1 0 0 0 0 0 0 0 0 1
1 0 8 0 0 16 0 0 7 0 0 0 16 0 0 0 0 0 7 0 0 13 0 0 7 0 0 0 0 0 1 0 0 0 0 3 3 3 3 1
1 0 0 0 0 0 16 0 1 2 2 2 0 2 2 2 2 2 3 0 0 16 0 0 3 1 1 1 1 7 1 0 0 0 3 3 10 3 3 1
1 0 0 12 0 12 0 0 1 0 0 2 0 2 0 0 0 0 3 0 0 0 0 3 3 0 0 0 2 0 1 0 0 3 3 0 14 0 3 1
1 0 0 0 0 0 0 0 1 0 0 2 0 2 0 0 0 0 3 0 0 0 14 10 3 0 0 0 2 0 1 0 0 3 10 14 0 14 10 1
1 1 1 1 1 1 1 1 1 0 0 2 0 2 0 0 0 0 3 0 0 0 0 3 3 0 0 0 2 0 3 3 3 3 3 0 0 0 3 1
1 0 0 0 0 0 0 0 0 0 0 2 0 2 0 0 0 0 3 3 3 3 3 3 3 0 0 0 2 0 7 0 0 0 0 16 16 0 3 1
1 0 0 0 0 0 0 0 0 0 0 2 0 2 2 2 2 2 2 2 2 2 2 2 2 2 2 2 2 0 3 3 3 3 3 0 0 0 3 1
1 0 0 0 0 0 0 0 0 0 0 2 0 7 0 0 16 0 0 0 0 0 0 0 0 0 0 0 0 0 0 0 0 0 3 0 0 0 3 1
1 0 0 0 0 0 0 0 0 0 0 2 0 2 2 2 2 2 2 2 1 7 11 11 11 11 11 11 7 1 1 1 1 7 3 13 13 13 3 1
1 0 0 0 0 0 0 0 3 3 3 2 7 2 3 3 3 3 0 0 1 0 0 0 16 16 0 0 0 1 0 0 1 0 1 3 3 3 3 1
1 0 0 0 0 0 0 0 3 0 0 0 16 0 0 0 0 3 0 0 1 0 0 0 0 0 0 0 0 1 0 0 1 0 1 0 0 0 0 1
1 0 0 0 0 0 0 0 3 0 0 0 0 0 0 0 13 3 0 0 1 0 0 0 0 0 0 0 0 1 0 0 1 0 1 0 0 0 0 1
1 0 0 0 0 0 0 0 3 0 0 14 0 14 0 0 13 3 0 0 1 0 0 0 0 0 0 0 0 1 0 0 1 9 1 0 0 0 0 1
1 0 0 0 0 0 0 0 3 0 0 0 0 0 0 0 0 3 0 0 1 0 0 14 0 0 14 0 0 1 0 0 1 1 1 0 0 0 0 1
1 0 0 0 0 0 0 0 3 3 3 3 3 3 3 3 3 3 0 0 1 0 1 10 1 1 10 1 0 1 0 0 0 0 0 0 0 0 0 1
1 0 0 0 0 0 0 0 0 0 0 0 0 0 0 0 0 0 0 0 1 1 1 1 1 1 1 1 1 1 0 0 0 0 0 0 0 0 0 1
1 0 0 0 0 0 0 0 0 0 0 0 0 0 0 0 0 0 0 0 0 0 0 0 0 0 0 0 0 0 0 0 0 0 0 0 0 0 0 1
1 0 0 0 0 0 0 0 0 0 0 0 0 0 0 0 0 0 0 0 0 0 0 0 0 0 0 0 0 0 0 0 0 0 0 0 0 0 0 1
1 0 0 0 0 0 0 0 0 0 0 0 0 0 0 0 0 0 0 0 0 0 0 0 0 0 0 0 0 0 0 0 0 0 0 0 0 0 0 1
1 0 0 0 0 0 0 0 0 0 0 0 0 0 0 0 0 0 0 0 0 0 0 0 0 0 0 0 0 0 0 0 0 0 0 0 0 0 0 1
1 0 0 0 0 0 0 0 0 0 0 0 0 0 0 0 0 0 0 0 0 0 0 0 0 0 0 0 0 0 0 0 0 0 0 0 0 0 0 1
1 1 1 1 1 1 1 1 1 1 1 1 1 1 1 1 1 1 1 1 1 1 1 1 1 1 1 1 1 1 1 1 1 1 1 1 1 1 1 1
